1111111111
1200000001
1011111111
1000101001
1010101111
1010001001
1011101001
1010100001
1010100031
1111111111
