лллллллллллллллллллл
ллJ               лл
лл  лллллллллллллллл
лл      лл  лл    лл
лл  лл  лл  лллллллл
лл  лл      лл    лл
лл  лллллл  лл    лл
лл  лл  лл        лл
лл  лл  лл      M лл
лллллллллллллллллллл
